NO ./path_to_the_north_texture
SO ./path_to_the_south_texture 
WE ./path_to_the_west_texture
EA ./path_to_the_east_texture
F 220,100,0
C 225,30,0


111111111111111111111111
100100000000000000000001
111111111011000001110001
100000000011N00001110111
111100111111111011100001
111101100000010111010101
110000001101010111000001
100000001 10000000011001
100000000100000011010101
111111111111111111111111


